_______________________________________________________________________________________________________________________
_______________________________________________________________________________________________________________________
_______________________________________________________________________________________________________________________
_______________________________________________________________________________________________________________________
_______________________________________________________________________________________________________________________
___#####_______________________________________________________________________________________________________________
___________#####_______________________________________________________________________________________________________
_______________________________________________________________________________________________________________________
________________________________________________/##############________________________________________________________
__________________#################\___________/###############________________________________________________________
__________________#############################################________________________________________________________
_______________________#####################################################___________________________________________
__________________________##############################################_______________________________________________
_______________________________________________________________________________________________________________________
____________________________________________________________________________________________###############____________
_______________________________________________________________________________________________#########_______________
_______________________________________________________________________________________________________________________
_______________________________________________________________________________________________________________________
_______________________________________________________________________________________________________________________
______##########____________________________________________________/##############____________________________________
______##################\__________________________________________/###############____________________________________
______###################\________________________________________/################____________________________________
________###########################################################################____________________________________
___________########################################################################____________________________________
___________##################################################################__________________________________________
_______________________________________________________________________________________________________________________
_______________________________________________________________________________________________________________________
_______________________________________________________________________________________________________________________
_______________________________________________________________________________________________________________________
_______________________________________________________________________________________________________________________
_______________________________________________________________________________________________________________________
_______________________________________________________________________________________________________________________
_______________________________________________________________________________________________________________________
_______________________________________________________________________________________________________________________
_______________________________________________________________________________________________________________________
_______________________________________________________________________________________________________________________
_______________________________________________________________________________________________________________________
_______________________________________________________________________________________________________________________
_______________________________________________________________________________________________________________________